1111111111
10P0000011
100C000001
1000000001
1000000001
100C000001
100000E001
1111111111