111111111111111111111111111111111111
10P100010001000100010C01000100010001
11000C010001C00000000001000100010001
1C0001000100001C00100000010001000E01
111111111111111111111111111111111111
111111111111111111111111111111111111
110000000000000000100000000000000001
111111111111111111111111111111111111